@########################
------------------------#
------------------------#
------------------------#
####--------------####--#
---######---------#--#--#
--------#----######---#-a
---------#####--------###
------------------------#
------------------------#
------------------------#
------------------------#
------------------------#
------------------------#
------------------------#
------------------------#
AAAAAAAAAAAAAAAAAAAAAAAA#
#########################