@####################################
------------------------------------#
----------####----------------------#
------------------------------------#
##---------------####---------------#
---######------------------##-------a
-------------#--###---------------###
------------#------#--##-##-##-#----#
------------------------------------#
AAAAAAAAAAAAAAAAAAAAAAAAAAAAAAAAAAAA#
############## Level 4 ##############