@####################################
------------------------------------#
------------------------------------#
######------------------------------a
--------------------###--#########-##
-----######-------------------------#
-----------#------#-----------------#
--######----###-###-----------------#
------------------------------------#
AAAAAAAAAAAAAAAAAAAAAAAAAAAAAAAAAAAA#
############## Level 2 ##############