@####################################
------------------------------------#
---F--------##---------------#------#
######-----#----------------------X-a
------E------------####--##-###--####
-----###-----#----------------------# 
-------------L--------#---I---------#
-##---------###-###------####-------#        
------------------------------------#
AAAAAAAAAAAAAAAAAAAAAAAAAAAAAAAAAAAA#
############## Level 5 ##############