@####################################
------------------------------------#
------------------------------------#
------------------------------------#
####--------------####--------------#
---######---------#--##-------------a
--------#----######---#-----------###
---------####---------############--#
------------------------------------#
AAAAAAAAAAAAAAAAAAAAAAAAAAAAAAAAAAAA#
############## Level 1 ##############
