@####################################
------------------------------------#
------------------------------------#
------------------------######------a
--------------------------------#####
-----######--------##---------------#
-----------#------##----------------#
##-#####----###--##-----------------#
------------------------------------#
AAAAAAAAAAAAAAAAAAAAAAAAAAAAAAAAAAAA#
############## Level 3 ##############