@####################################
------------------------------------#
##########-###########-###########-##
#---------------#------###------##-##
#---------------#---#--#-------#----#
##############-##--#---######-------#
#--------------##-####------#-#######
##############-##-###########-------#
a---------------#-------------------#
#####################################
