####################
#@---#-------------#
#------#---#######-#
#####-##-########--#
#a--#-#---#-------##
###--######-####--##
#-##-----------#--##
#-##############---#
#------------------#
####################