@####################################
------------------------------------#
-------------------#-#--------------#
--###-##############-######-#####---#
###------#---------#-#----------###-#
-##----------------#-#---#------##--#
-##-####-###########-----#AAAAAA##--#
-##-#---------------#-----------##--#
-##-#-A---####--------############--#
###A#a##A####AA######A###############
############## Level 1 ##############
