@####################################
------------------------------------#
--######-########################---#
-###---------------------------###--#
--##-A-A------------A-A--------##---#
--##-######-###---###########-###--##
--##------------##-----A-------#----#
--##-------A----#-------------###---#
--##-------#----Aa-----A-------------
#####A#A##################AAA#AA#####
############## Level 4 ##############
