@####################################
------------------------------------#
-#-#---#-#-----------#-#---#-#-------
##-##-#---###########---#-##-##-----#
-#----#-------------#--------#---#--#
-#-A--####A###AA###-#-A-#-##-#--###-#
-###--#--A--------------#--###--###-#
-#---##------############--#-#------#
-#----#--AAA-----------a#----#--#-#-#
####A---#############################
############## Level 2 ##############
