@####################################
------------------------------------#
------------------------------------#
------##--------------------##------#
-----#--#------------------#--#-----#
----###-#####################-##----#
---##-----F---E---L---I---X----##---#
---##---#####################--##---#
---##-------------a------------##---#
#####A########################A######
############## Level 5 ##############
