@####################################
---------------------#-#------------#
------##-#############-#####-#------#
----##------------------------##----#
-----#------A-A-A----AAA------#-----#
-----#############-##########-#----##
-#---------------#-#----------#---###
-#---#---A-------#-#----------#---#-#
-#---#---A--AA--a#-#AAAAAAAAAA#---#--
######A############A#############---#
############## Level 3 ##############
